vtkgn: qjwok tgthz nraqp kskrb bdyym gduct ixozu uilia glydm iekxl tdivv
kuhmp: utaya jybkk avncd uraen fvgnr esjpd mvwve fuivc wbfba iekxl
xnhtq: royyx rvnue sifhm gduct kznbt bxffr tkxlc mdwyi eeprm qnkqk yuhor zilsr
gxzvx: hyyqe xlicw bdyym hvbak rpuhr upzad grhjo uwdnq tibhg okjza adguv
isxrm: yrofc prkjz wbfba uyalc gbear qepps durzk ujbas sifhm xfnpv guljb qvgtd ctwyv pkcgh fizxv
clpxz: viedr qnyyy ujbas qwhzc tgthz rwmxi alrax qjwok
mwguo: yplrz blsbv nwdqd yrofc zkpkb kgceb siqbh rzbrv aknlm dkqcl tkhmk xxqjz amwgi jybkk btsrs
askvr: bbymx dkqcl bkikc mdwyi grhjo txpau znxno mwpmq rwmxi jvgoa vxusk bxffr
amwgi: ydzjm qldpg oipad uwdnq wkchl yplrz znxno uyalc eeprm dsbox mkoni kmata prkjz jwhab mwsrd
weogz: zldcc tdaqa nhwjl rmymi oyjqi gaueu
ulcin: tkxlc mmrfp ujbas durzk jkgnt oyjqi ltvbe rjmkm
ycoso: qbctb nhwjl xitav psrjx qxcvn ultlu xmvzi
vozpp: kvbqd upzad jvgoa glydm qepps mvwve
lpkoh: yjhjy ulktl ydaja lgenm dkqcl ekhno upzad avncd xucpm ctwyv qbctb
eeprm: gqhev zcpex zkpkb jtvxe
ctwyv: qldpg fvgnr tvtjp qnyyy wgpsv dzzdk yuigt jkgnt dsbox siqbe
xyoks: jybkk zscbj tkxlc psrjx rpuhr yuigt bbymx ydaja
hvwxp: qldpg mslht rzbrv ayedf gqhev zscbj yuigt okjza psubc kvbqd
yplrz: lsndx tgthz oyjqi xlicw recyp nbczf
xucpm: kznbt dzzdk tgthz kadwn uyalc ixozu esjpd oyjqi frtiw hlpng jkgnt
qvgtd: vxusk btsrs lukuk qldpg uraen hingx
fuivc: rpuhr hclox znxno tdivv btsrs ujbas gbear jkgnt
dsbox: ajazv hkbda txpau lukuk avncd ghtrt xmvzi ltvbe chdgj qnyyy
nraqp: ujbas rpuhr zkxfl aknlm fvgnr mdwyi mdaqq gfqje fthcl
okjza: fizxv bxffr jeizt wbfba jwhab gfqje fthcl
ayedf: kznbt uyalc mdwyi otwmi jeizt gqhev hclox znxno rjmkm fnizz dxuxw
uyalc: rwmxi qnkqk vxusk avncd pweci
gfqje: tdaqa ydaja ujbas oipad rjmkm fdfjo recyp tkhmk ixozu yuigt
nbczf: uuosf fvgnr tgthz blsbv otwmi dwbgn tkxlc nhwjl grhjo bjfne gduct
jtvxe: cbkot gisby xxqjz qzwss tkhmk guljb bxffr ulktl utaya
rzbrv: lsndx ydaja esjpd fthcl gbwyh zkpkb yjhjy lohof
igple: xanbw gisby rmbxk dkfby viedr rmymi ixozu jeizt nwdqd mwsrd znxno ykcut ekhno
mkoni: kmata dzzdk jybkk zscbj bdyym dwbgn qnkqk pweci siqbe
jvgoa: tibhg txpau otwmi recyp jwhab frtiw mwpmq qepps
tibhg: recyp mgben bdyym qafig psrjx zqcsz xanbw uuhjq
yjhjy: mmrfp kmata xanbw padiu siqbh
qqskk: hkbda recyp kskrb foizy gqhev
qafig: cbkot lohof uwdnq nwdqd qxcvn rwmxi royyx frtiw qahtq
qjwok: zkxfl rutzt kvbqd upzad
kskrb: gisby bjfne jybkk mukpw mslht glydm wbfba yuhor cbkot
lgenm: fvgnr siqbh wsxlr rtrab uwdnq
otwmi: pkcgh rmymi uwdnq recyp tkxlc tdaqa
mvwve: ulktl kvbqd bxffr rpuhr rutzt xqjnf prkjz
zqcsz: znxno rmymi ydaja rjmkm fnizz hyyqe utaya
krifs: zscbj lsndx jwhab hclox
avncd: nwdqd wkchl xfnpv hyyqe ulktl fnizz vxusk zscbj oyjqi
qwhzc: blsbv adguv qldpg jwhab ydzjm siqbh tbqam zkxfl
wkchl: rvnue fnizz qbctb siqbh fdfjo yrofc esjpd tbqam
uwdnq: rjmkm mwpmq cojju jybkk mslht ffypb ghtrt
jwhab: jeizt dkfby ydaja zldcc bjfne tdaqa
royyx: bfrbb btsrs ykcut zkpkb qmfas dkqcl uraen wbfba ypmsf nhwjl prkjz mgben
btsrs: oesmr znxno kznbt rmbxk
xqjnf: qepps siqbh oipad zldcc nwdqd qahtq
padiu: gisby durzk jybkk qmfas foizy grhjo zhkoh
siqbe: tkhmk ffypb znxno psrjx jkgnt yuigt ghtrt
zhkoh: fthcl tvtjp rtrab dxuxw uraen
mgben: zkpkb bdyym tbqam uraen ltvbe pweci ydaja ghtrt mmrfp
bkikc: glydm rutzt rtrab mdwyi mdaqq
xmvzi: uuhjq vxusk wsxlr
mslht: qmfas oyjqi vxusk psubc yrofc idrqu
xxqjz: xlicw dwbgn
qbctb: bjfne gqhev jybkk psubc uuhjq
aknlm: kadwn rutzt tvtjp ykcut blsbv tjrsr uuosf zkxfl hvbak
prkjz: jeizt vxusk rtrab znxno bfrbb utaya
guljb: ghtrt uuhjq gbear kgceb fvgnr
wsxlr: qnyyy mwpmq pkcgh
dkfby: kmata kgceb qahtq dzzdk hvbak pkcgh bjfne ykcut xlicw esjpd mdwyi viedr gqhev xfnpv oipad
fdfjo: ypmsf hvbak oipad lukuk bxffr dkqcl nhwjl
dzzdk: qahtq oipad ajazv idrqu wbfba mdaqq psrjx ydaja
rwmxi: yuhor qnkqk ixozu jybkk frtiw bdyym ydaja kvbqd esjpd mdwyi yrofc
mmrfp: zkpkb qmfas zcpex qzwss ydaja lukuk
fizxv: qnyyy gqhev znxno mdaqq cojju rmymi tkhmk fvgnr
adguv: sifhm fnizz zscbj mdwyi ydaja
psubc: znxno rpuhr zkpkb hvbak qldpg ltvbe
wbfba: gaueu jlafq
viedr: txpau ulktl sifhm ogrls durzk
znxno: tjrsr cojju ykcut glydm ultlu rjmkm
rutzt: zldcc bfrbb nwdqd zkxfl ydaja psrjx grhjo idrqu
xfnpv: recyp ogrls hlpng ultlu oipad glydm ydaja qahtq bbymx rjmkm kvbqd yuigt
mukpw: siqbh mdaqq pkcgh durzk sifhm
uraen: tgthz ajazv tkxlc hclox durzk
gbwyh: xanbw rmymi nhwjl zcpex qepps xlicw tgthz oesmr
kvbqd: txpau nwdqd oesmr idrqu gaueu jlafq bbymx
hvbak: gduct hlpng oipad glydm qepps
mwsrd: ixozu grhjo jkgnt ydzjm pweci ekhno fnizz yuigt ultlu ajazv
zkpkb: siqbh
mdaqq: fnizz lsndx uuhjq rtrab esjpd fthcl
cojju: tdivv yrofc rtrab hingx mwpmq gaueu
mwpmq: fthcl yrofc glydm pweci tdivv ogrls kmata bjfne ffypb
idrqu: bjfne bxffr zldcc ykcut dxuxw ypmsf hingx
dxuxw: uuosf qmfas bbymx jybkk gisby cbkot
rvnue: siqbh bxffr tbqam fnizz
ultlu: tdaqa gaueu qzwss
bbymx: iekxl jlafq rmbxk qahtq lohof dwbgn
yrofc: txpau rjmkm xanbw chdgj hclox rmymi hlpng qepps ulktl
vxusk: xanbw kznbt recyp yuigt bjfne rmbxk
hclox: rjmkm ixozu bfrbb chdgj frtiw tdivv tdaqa ykcut
ykcut: qahtq
alrax: uuosf blsbv foizy zcpex jlafq
zscbj: xlicw kmata txpau ogrls oipad
ajazv: utaya iekxl lukuk kgceb zkxfl jeizt
bxffr: ixozu tjrsr mdwyi txpau yuigt uuosf
ydaja: oyjqi oipad rpuhr kznbt chdgj
pweci: kgceb tdaqa fthcl rmbxk cbkot hingx durzk
ydzjm: fnizz gbear ujbas lohof yuhor qepps
hyyqe: gisby uilia uuosf jybkk jkgnt
zcpex: ujbas
yuigt: ixozu zilsr dkqcl zldcc gaueu
hkbda: jybkk dkqcl jeizt oipad nhwjl
cbkot: psrjx zkxfl chdgj uuhjq kadwn
dkqcl: upzad bjfne grhjo foizy
jybkk: ujbas grhjo oesmr
sifhm: ixozu fthcl kznbt gaueu qnkqk ulktl ghtrt
yuhor: hingx rtrab psrjx txpau
ulktl:
glydm: xitav upzad
qmfas: tvtjp bfrbb rmymi iekxl oyjqi
qahtq: rjmkm grhjo tkhmk tjrsr uuosf
oesmr: qnyyy kadwn mdwyi
tgthz: qldpg bdyym
dwbgn: qnyyy utaya ffypb rjmkm tvtjp foizy ogrls
pkcgh: ghtrt ltvbe qldpg qnyyy nhwjl
txpau: bdyym zldcc
hingx: tbqam tkxlc jkgnt qnyyy uuosf
ekhno: tdaqa xanbw recyp
qnkqk: uuhjq mdwyi kadwn zilsr esjpd
uuhjq: tkhmk ixozu tkxlc uilia gbear
esjpd: tvtjp hlpng rmbxk
rjmkm: xitav iekxl foizy zldcc fnizz uilia
siqbh: rmbxk tdivv bdyym
tbqam: bjfne ogrls oyjqi kznbt ffypb
xanbw: psrjx ypmsf
rtrab: recyp jkgnt gbear
qzwss:
fthcl: mdwyi blsbv chdgj
iekxl: zkxfl durzk xlicw qepps fvgnr
lsndx: tkhmk mdwyi zkxfl ujbas tvtjp
lukuk: fvgnr
ffypb: utaya rpuhr jlafq tkhmk
kgceb: lohof rmymi
qepps: tjrsr chdgj kznbt gduct
nhwjl: bdyym ogrls tdivv gbear
qnyyy: ixozu psrjx tdaqa fnizz ghtrt
ypmsf: upzad rmymi
gbear: bjfne xitav xlicw fnizz
durzk: gqhev upzad
xlicw: uuosf zldcc
uilia: bfrbb ujbas
bjfne: chdgj fvgnr
frtiw: mdwyi tkxlc xitav
gisby: ogrls jeizt
blsbv: rmbxk ujbas
zldcc: xitav rpuhr mdwyi oipad recyp
tkxlc: tjrsr recyp grhjo zilsr kmata
ltvbe: tvtjp upzad
mdwyi: recyp zkxfl upzad
lohof: jlafq
hlpng: jlafq oipad
gduct: qxcvn wgpsv bdyym zilsr
ghtrt: zilsr
nwdqd: rpuhr
tjrsr: tdivv ixozu
fvgnr: bdyym
gqhev: ixozu jeizt grhjo
oipad: rmbxk utaya qldpg
kznbt: jlafq xitav bdyym
uuosf: kmata
tvtjp: tdaqa chdgj
qxcvn: rmbxk
jlafq: ixozu jkgnt
rmymi: jkgnt
wgpsv:
ujbas: jkgnt kadwn utaya
zilsr: upzad grhjo
grhjo: chdgj
tdaqa: rmbxk
bfrbb: upzad tkhmk
zkxfl: bdyym oyjqi
jeizt: kmata
jkgnt:
rmbxk:
kadwn: utaya
tdivv: xitav
gaueu: qldpg
recyp: qldpg tkhmk oyjqi
qldpg:
utaya:
chdgj: bdyym
tkhmk:
ixozu:
ogrls:
kmata:
rpuhr:
fnizz:
foizy: upzad
psrjx: xitav
xitav:
oyjqi:
upzad:
bdyym:
